111111111
100000001
111111111
10100P0C1
1010000C1
1010000C1
1010000C1
1C000C0E1
111111111