111111111
1P00000C1
101111111
1010000C1
1010000C1
1010000C1
1010000C1
1C000C0E1
111111111