1111111111111
10C1CCC0000C1
10C0011111001
1P0E11C0000C1
1111111111111