1111111111111
1001CCC0000C1
1000011111001
1P0E11C0000C1
1111111111111